The Bachelorette	@BacheloretteABC	#thebachelorette, #BleachableMoment, #VoteBachelorCraig, #VoteBachelorJosh, #VoteBachelorJJ, #VoteBachelorAndrew	@Clare_Crawley, @AndiDorfman, @Nikki_Ferrell, @JuanPaGalavis
Beauty and the Beast	@cwbatb	#batb, #Vincat, #beasties	
Bet on Your Baby	@betonyourbaby	#BetOnYourBaby	@Followtheblonde
Crossbones	@NBCCrossbones	#blackbeard, #crossbones, #johnmalkovich	
Escape Club	@EscapeClubTV	#escapeclub	
Extreme Weight Loss	@ExtWeightLoss	#ewl, #extremeweightloss	
Gang Related	@GangRelatedFOX	#gangrelatedfox	
Halt and Catch Fire	@HaltAMC	#HaltandCatchFire 	
Hit the Floor	@HitTheFloor	#HTF, #Hit The Floor, #AhshaAndDerek, #HTFOMG, #DevilGirls	
Jennifer Falls	@JenniferFallsTV	#jenniferfalls	
Jimmy Kimmel Live	@JimmyKimmelLive	#meantweets, #kimmel	
Keeping Up With the Kardashians	@KUWTK	#kuwtk	@KimKardashian, @khloekardashian, @kourtneykardash, @robkardashian, @KendallJenner, @KylieJenner, @ScottDisick, @RealLamarOdom, @KrisJenner
Last Comic Standing	@nbclastcomic	#lastcomic, #lastcomicstanding	
Major Crimes	@MajorCrimesTNT	#majorcrimes, #tntboom	
Mistresses	@Mistresses_ABC	#mistressess	
Motive	@MotiveABC	#motive	
Orange Is the New Black	@OITNB	#OITNB	
Power	@Power_Starz	#PowerTV #PowerPremiere	
Pretty Little Liars	@ABCFpll	#pll, #pllarmy, #prettylittleliars, #pll100party	
So You Think You Can Dance	@DANCEonFOX	#sytycd, #SYTYCDporeotics, #SYTYCDladies, #sytycdpremiere, #sytycdNYC, #sytycdLA, #sytycdPhilly, #sytycdChicago, #sytycdBoston, #sytycdDC, #sytycdAtlanta, #sytycdHouston	@HOTtamaleTRAIN, @waynebrady, @dizzyfeet, @catdeeley
Undateable	@NBCUndateable	#undateable	
The Wil Wheaton Project	@wilwproject	#WilWProject, #PoopWheaton	@wilw
I Wanna Marry "Harry"	@MarryHarryFox	#marryharry	
MasterChef	@MASTERCHEFonFOX	#masterchef, #mctop22, #mcaprons	@GordonRamsay, @Jbastianich, @grahamelliot
Mountain Men	@MountainMen	#mountainmen	
Royal Pains	@RoyalPains_USA	#RoyalPains, #HankMed	
Satisfaction	@SatisfactionUSA	#SatisfactionUSA, #satisfaction
The 100	@cwthe100	#the100	
America's Got Talent	@nbcagt	#agt, #GoldenBuzzer, #TodaysGotTalent, #SummerStartsNow, #NickPrank, #TurnUpTheTalent, #AmericasGotTalent	@heidiklum, @howiemandel, @HowardStern, @OfficialMelB, @NickCannon
America's Got Talent	@nbcagt	nbcagtâ€Ž	#agt #nbcagt #AGT #America's Got Talent #JudgmentWeek #RoadToRadioCityAwkward	@MTVAwkward		#mtv awkward #eva and matty #eva #matty #sadie saxton #jenna hamiltonBring It	@BringItLifetime		#bringit #dd4lBrooklyn NineNine	@Brooklyn99FOX	Brooklyn99FOX	#brooklyn99Chasing Life	@ChasingLifeABCF		#TeamLapril #TeamDapril #ChasingLifeDallas	@Dallas_TNT	officialdallastnt	#DallasTNTDating Naked	@DatingNaked		#datingnakedDevious Maids	@DeviousMaids		#DeviousMaids #DeviousArmyFace Off	@FaceOffSyfy		#faceoffFood Fighters	@NBCFoodFighters		#foodporn #foodfighters #nbcfoodfightersThe Fosters	@TheFostersABCF		#thefostersHell on Wheels	@HellOnWheelsAMC		#hellonwheelsHemlock Grove	@HemlockGrove		#hemlockgroveHollywood Game Night	@NBCGameNight		#hollywoodgamenight #janelynch #hgnHouse of Lies	@SHO_HouseOfLies		#houseofliesThe Killing	@TheKilling		#thekillingThe Last Ship	@TheLastShipTNT		#rockthelastship #thelastship #thelastshiptntManhattan	@ManhattanWGNA	manhattanwgna	#donttalk #mahattanproject #nuclearfamilyMasters of Illusion	@cw_illusion		#mastersofillusionMasters of Sex	@SHO_Masters		#mastersofsexPenn Teller Fool Us	@CWPennandTeller		#pennandtellerProject Runway	@ProjectRunway	ProjectRunway	#projectrunwayThe Quest	@TheQuestABC		#thequestRay Donovan	@SHO_RayDonovan	N/A	#raydonvovanReckless	@RecklessCBS		#recklessRush	@RUSHonUSA		#rushSuits	@Suits_USA		#suitsTeen Wolf	@MTVteenwolf		#teenwolfThe Tonight Show Starring Jimmy Fallon	@FallonTonight	fallontonight	#fallontonightTrue Blood	@TrueBloodHBO		#trueblood #truetotheend #trueevolutionUnder the Dome	@UnderTheDomeCBS		#underthedomeWitches of East End	@WitchesEastEnd		#witchesofeastend #witcheesWho Do You Think You Are	@wdytya		#whodoyouthinkyouare #wdytyaYoung  Hungry	@YoungandHungry		#youngandhungrySupernatural	@cw_spn	cw_supernatural	#supernatural #spnfamily #jimionsReign	@CWReign	cw_reign	#reignBeauty and the Beast	@cwbatb	cwbatb	#batb #vincat #beastiesArrow	@CW_Arrow		#arrowHart of Dixie	@cwhartofdixie	hartofdixiepas	#hartofdixieThe 100	@cwthe100		#the100Whose Line Is It Anyway	@cwwhoseline		#wliiaThe Vampire Diaries	@vampirediaries		#tvdThe Originals	@cworiginals		#theoriginals
